8
._______________________________________
..................@...........$........|
|..._..................@.........#.....|
|...........$.................*........|
|.....*........#......_.......@........|
|.........@..........._................|
|...$........|.............|...........|
________________________________________
v>v^><>>>>>vvv<^>>>v<^^<<v>>>^<vvvvvvvvvvvv>>>>>>>>>>>>>>>>>>^^^^^^^^^^^^^^^^^<<<<<<<<<<<<<<<<<